across	가로질러서
deny	부인하다
and	그리고 
among	~사이에
likely	있음직한
recent	최근의 
wrong	잘못된
further	더 나아가/ 더 멀리
big	큰
fix	고치다
misconception	오해
discovery	발견
hatred	혐호
upright	똑바로 선
novel	소설
film	영화
driven	유해한
problem	문제
convey	전달하다
former	전자의
library	도서관
pad	판